            _____      _           _     _____ _                   
           /  ___|    | |         | |   /  ___| |                  
           \ `--.  ___| | ___  ___| |_  \ `--.| |_ __ _  __ _  ___ 
            `--. \/ _ \ |/ _ \/ __| __|  `--. \ __/ _` |/ _` |/ _ \
           /\__/ /  __/ |  __/ (__| |_  /\__/ / | |(_| | (_| |  __/
           \____/ \___|_|\___|\___|\__| \____/ \__\__,_|\__, |\___|
                                                         __/ |     
                                                        |___/      
                                                            